TRANSACCIONES POR FECHA;;;;;
;;;;;
Banco Promerica Costa Rica;;;;;
Fecha del reporte: martes, 18 de febrero de 2025 07:41;;;;;
Rango de Fechas: 22/11/2024 - 24/11/2024;;;;;
Número de cuenta: 40000002340333-PREMIA ELECTRONICA BASICA DOLARES;;;;;
Transacciones;;;;;
Fecha;Documento;Descripción;Débitos;Créditos;Saldo
22.11.2024;11548769;Crédito por DTR a cuenta 40000002340333;;43,000.00;247,069.48
22.11.2024;567599413;CAPITALIZACION NORMAL DE INTERESES;;5.41;247,074.89
23.11.2024;56765709;TEF. ELEC Fact 149 Alq Inmob Ilanca;7,119.00;;239,955.89
23.11.2024;56766471;TEF. ELEC Factura Profesional 115700239;;27.11;239,983.00
23.11.2024;567771534;CAPITALIZACION NORMAL DE INTERESES;;5.26;239,988.26
24.11.2024;567919750;CAPITALIZACION NORMAL DE INTERESES;;5.26;239,993.52
;;;;;
Total de Débitos;7,119.00;;;;
Total de Créditos;43,043.04;;;;
