Número de Referencia,Fecha de Movimiento,Descripción,Monto,Saldo,Crédito/Débito
10460631,06/11/2024,pg fac 371313 carrofacil,316.40,"2,301.72",Crédito
12009082,12/11/2024,3101348298 Cl. 12990 Fra 372048,111.45,"2,413.17",Crédito
8287434,14/11/2024,Pago FE 4360,"1,044.46","1,368.71",Débito
5322182,21/11/2024,cancela fact 374322 hosting arqavi dic 2024,22.59,"1,391.30",Crédito
11563924,22/11/2024,PAGO CYBERFUEL NOV,27.11,"1,418.41",Crédito
15013726,27/11/2024,FT 374215 DE CF FREE,30.00,"1,448.41",Crédito
17207678,29/11/2024,DTR BAC A SCOTIABANK DOLARES,"4,000.00","5,448.41",Crédito
11519926,29/11/2024,Pago FE 4347,"5,272.40",176.01,Débito
